A 	a 	a
Ą 	ą 	ą; a z ogonkiem
B 	b 	be
C 	c 	ce
Ć 	ć 	cie; ce z kreską
D 	d 	de
E 	e 	e
Ę 	ę 	ę; e z ogonkiem
F 	f 	ef
G 	g 	gie
H 	h 	ha
I 	i 	i
J 	j 	jot
K 	k 	ka
L 	l 	el
Ł 	ł 	eł
M 	m 	em
N 	n 	en
Ń 	ń 	eń; en z kreską
O 	o 	o
Ó 	ó 	o z kreską; o kreskowane; u zamknięte
P 	p 	pe
R 	r 	er
S 	s 	es
Ś 	ś 	eś; es z kreską
T 	t 	te
U 	u 	u; u otwarte
W 	w 	wu
Y 	y 	y; igrek
Z 	z 	zet
Ź 	ź 	ziet; zet z kreską
Ż 	ż 	żet; zet z kropką